#######
#. $  #
#  @  #
#  $ .#
#######
