#########
#     ..#
#   # $ #
### #@###
  #$# #
  #   #
  #####